Feux pâles
Une fiction interactive par Alexia Schneider
Release 1 / Serial number 250826 / Inform 7 build 6L38 (I6/v6.33 lib 6/12N) SD

Préambule
L'énigme commence à l'entrée, dans le « préambule » de l'exposition, où est inscrit le titre de l'exposition au-dessus d'un code-barres signé par le capc.  Une pièce vide, des murs blancs, le Musée d'art Contemporain de Bordeaux en 1991. 
 À l'ouest se trouve l'Inventaire du mémorable.

>test
>--> The following tests are available:
'test me'

>test me
(Testing.)

>[1] x me
As good-looking as ever.

>[2] x titre
Sur le mur blanc, "Feux pâles" en grande lettre noires sans sérif. Un code-barre de grande dimension se trouve juste en dessous.

>[3] w

L'inventaire du mémorable
Dans cette première salle, sont regroupés dans trois grandes armoires des objets « merveilleux » comme un mémento mori en forme de crâne, une horloge de table côtoyant des stalactites ou encore un ouvrage (fermé) de C. Plinii 18. En dehors des vitrines, quatre moulages de bustes antiques côtoient des animaux naturalisés. La curiosité du visiteur poursuit sa découverte dans le trompe-l"œil Scarabattolo de Domenico Remps.

>[4] e

Préambule
Le Préambule est une pièce vide, un mur blanc seulement avec un titre et un code-barre.

You can see a titre and a code-barre here.

* * *

Feux pâles
Une fiction interactive par Alexia Schneider
Release 1 / Serial number 250826 / Inform 7 build 6L38 (I6/v6.33 lib 6/12N) SD

Préambule
L'énigme commence à l'entrée, dans le « préambule » de l'exposition, où est inscrit le titre de l'exposition au-dessus d'un code-barres signé par le capc.  Une pièce vide, des murs blancs, le Musée d'art Contemporain de Bordeaux en 1991. 
 À l'ouest se trouve l'Inventaire du mémorable.

>test me
(Testing.)

>[1] x moi
Tu es Jedermann N.A. En quoi ça consiste exactement ? Allez savoir. Tu tiens un catalogue.

>[2] x titre
Sur le mur blanc, "Feux pâles" en grande lettre noires sans sérif. Un code-barre de grande dimension se trouve juste en dessous.

>[3] o

L'inventaire du mémorable
Dans cette première salle, sont regroupés dans trois grandes armoires des objets « merveilleux » comme un mémento mori en forme de crâne, une horloge de table côtoyant des stalactites ou encore un ouvrage (fermé) de C. Plinii 18. En dehors des vitrines, quatre moulages de bustes antiques côtoient des animaux naturalisés. La curiosité du visiteur poursuit sa découverte dans le trompe-l"œil Scarabattolo de Domenico Remps.

>[4] e

Préambule
Une pièce vide, un mur blanc seulement avec un titre et un code-barre.

Dans cette salle on trouve : vous-même, titre et code-barre 
>[5] contemple titre
Sur le mur blanc, "Feux pâles" en grande lettre noires sans sérif. Un code-barre de grande dimension se trouve juste en dessous.

>[6] o

L'inventaire du mémorable
Dans cette première salle, sont regroupés dans trois grandes armoires des objets « merveilleux » comme un mémento mori en forme de crâne, une horloge de table côtoyant des stalactites ou encore un ouvrage (fermé) de C. Plinii 18. En dehors des vitrines, quatre moulages de bustes antiques côtoient des animaux naturalisés. La curiosité du visiteur poursuit sa découverte dans le trompe-l"œil Scarabattolo de Domenico Remps.

>[7] frappe mur
[Je n'ai pas compris cette phrase.]

>x code-barre
Le code barre ne donne aucune indication particulière.

>x catalogu
You can't see any such thing.

>x catalogue
Le catalogue de l'exposition Feux pâles. Sa couverture est orange. Pour accéder à une page ou section, CONSULTER L'INDEX ou CONSULTER SECTION <titre de la section>

* * *

>frappe
That's not a verb I recognise.

>mange
That's not a verb I recognise.

>eat
(the catalogue)
Un visiteur de musée éduqué ne se permettrait jamais ça.

* * *

>gauche
L'inventaire du mémorable
Dans cette première salle, sont regroupés dans trois grandes armoires des objets « merveilleux » comme un mémento mori en forme de crâne, une horloge de table côtoyant des stalactites ou encore un ouvrage (fermé) de C. Plinii 18. En dehors des vitrines, quatre moulages de bustes antiques côtoient des animaux naturalisés. La curiosité du visiteur poursuit sa découverte dans le trompe-l"œil Scarabattolo de Domenico Remps.

>est
Préambule
Une pièce vide, un mur blanc seulement avec un titre et un code-barre.

Dans cette salle on trouve : yourself, titre and code-barre

>g
You can't go that way.

>d
You can't go that way.

>droite
You can't go that way.

>gauche
L'inventaire du mémorable
Dans cette première salle, sont regroupés dans trois grandes armoires des objets « merveilleux » comme un mémento mori en forme de crâne, une horloge de table côtoyant des stalactites ou encore un ouvrage (fermé) de C. Plinii 18. En dehors des vitrines, quatre moulages de bustes antiques côtoient des animaux naturalisés. La curiosité du visiteur poursuit sa découverte dans le trompe-l"œil Scarabattolo de Domenico Remps.

>droite
Préambule
Une pièce vide, un mur blanc seulement avec un titre et un code-barre.

Dans cette salle on trouve : yourself, titre and code-barre

* * *

>e
Préambule
Une pièce vide, un mur blanc seulement avec un titre et un code-barre.

Dans cette salle on trouve : vous-même, titre et code-barre

>x code barre
Le code barre ne donne aucune indication particulière.

* * *

>frappe titre
[Je n'ai pas compris cette phrase.]

>x moi
Tu es Jedermann N.A. En quoi ça consiste exactement ? Allez savoir. Tu tiens un catalogue.

>e
Préambule
Une pièce vide, un mur blanc seulement avec un titre et un code-barre.

Dans cette salle on trouve : vous-même, titre et code-barre

>frappe titre
[Je n'ai pas compris cette phrase.]

>x titre
Sur le mur blanc, "Feux pâles" en grande lettre noires sans sérif. Un code-barre de grande dimension se trouve juste en dessous.

>frappe titre
[Je n'ai pas compris cette phrase.]

>x pancarte
Sur le mur blanc, "Feux pâles" en grande lettre noires sans sérif. Un code-barre de grande dimension se trouve juste en dessous.

>prendre signe
Voilà qui est fait.

>i
Vous avez :
  un titre
  un un catalogue

>l
Préambule
Une pièce vide, un mur blanc seulement avec un titre et un code-barre.

Dans cette salle on trouve : vous-même et code-barre

>l
Préambule
Une pièce vide, un mur blanc seulement avec un titre et un code-barre.

Dans cette salle on trouve : vous-même et code-barre

>l
Préambule
Une pièce vide, un mur blanc seulement avec un titre et un code-barre.

Dans cette salle on trouve : vous-même et code-barre 
(Si tu te sens perdu, pense à CONSULTER le catalogue.)

* * *

Feux pâles
Une fiction interactive par Alexia Schneider
Release 1 / Serial number 250826 / Inform 7 build 6L38 (I6/v6.33 lib 6/12N) SD

Préambule
L'énigme commence à l'entrée, dans le « préambule » de l'exposition, où est inscrit le titre de l'exposition au-dessus d'un code-barres signé par le capc.  Une pièce vide, des murs blancs, le Musée d'art Contemporain de Bordeaux en 1991. 
 À l'ouest se trouve l'Inventaire du mémorable.

>truc
That's not a verb I recognise.

Quel est ton nom ?

>Truc
That's not a verb I recognise.

Quel est ton nom ?

>x
(the catalogue)
Le catalogue de l'exposition Feux pâles. Sa couverture est orange. Pour accéder à une page ou section, CONSULTER L'INDEX ou CONSULTER SECTION <titre de la section>

Quel est ton nom ?

I beg your pardon?

Quel est ton nom ?

* * *

Feux pâles
Une fiction interactive par Alexia Schneider
Release 1 / Serial number 250826 / Inform 7 build 6L38 (I6/v6.33 lib 6/12N) SD

Préambule
L'énigme commence à l'entrée, dans le « préambule » de l'exposition, où est inscrit le titre de l'exposition au-dessus d'un code-barres signé par le capc.  Une pièce vide, des murs blancs, le Musée d'art Contemporain de Bordeaux en 1991. 
 À l'ouest se trouve l'Inventaire du mémorable.

>test m
>--> The following tests are available:
'test me'

>test me
(Testing.)

>[1] x me
Tu es Jedermann N.A. En quoi ça consiste exactement ? Allez savoir. Tu tient un catalogue.

>[2] x titre
Sur le mur blanc, "Feux pâles" en grande lettre noires sans sérif. Un code-barre de grande dimension se trouve juste en dessous.

>[3] w

L'inventaire du mémorable
Dans cette première salle, sont regroupés dans trois grandes armoires des objets « merveilleux » comme un mémento mori en forme de crâne, une horloge de table côtoyant des stalactites ou encore un ouvrage (fermé) de C. Plinii 18. En dehors des vitrines, quatre moulages de bustes antiques côtoient des animaux naturalisés. La curiosité du visiteur poursuit sa découverte dans le trompe-l"œil Scarabattolo de Domenico Remps.

>[4] e

Préambule
Une pièce vide, un mur blanc seulement avec un titre et un code-barre.

Il y a ici : yourself, titre and code-barre 
>[5] contemple titre
That's not a verb I recognise.

* * *

Feux pâles
Une fiction interactive par Alexia Schneider
Release 1 / Serial number 250826 / Inform 7 build 6L38 (I6/v6.33 lib 6/12N) SD

Préambule
L'énigme commence à l'entrée, dans le « préambule » de l'exposition, où est inscrit le titre de l'exposition au-dessus d'un code-barres signé par le capc.  Une pièce vide, des murs blancs, le Musée d'art Contemporain de Bordeaux en 1991. 
 À l'ouest se trouve l'Inventaire du mémorable.

>o
L'inventaire du mémorable
Dans cette première salle, sont regroupés dans trois grandes armoires des objets « merveilleux » comme un mémento mori en forme de crâne, une horloge de table côtoyant des stalactites ou encore un ouvrage (fermé) de C. Plinii 18. En dehors des vitrines, quatre moulages de bustes antiques côtoient des animaux naturalisés. La curiosité du visiteur poursuit sa découverte dans le trompe-l"œil Scarabattolo de Domenico Remps.

>sud
I didn't understand that sentence.

* * *

>o
L'inventaire du mémorable
Dans cette première salle, sont regroupés dans trois grandes armoires des objets « merveilleux » comme un mémento mori en forme de crâne, une horloge de table côtoyant des stalactites ou encore un ouvrage (fermé) de C. Plinii 18. En dehors des vitrines, quatre moulages de bustes antiques côtoient des animaux naturalisés. La curiosité du visiteur poursuit sa découverte dans le trompe-l"œil Scarabattolo de Domenico Remps.

>w
Un visiteur de musée éduqué ne se permettrait jamais ça.

>no
Un visiteur de musée éduqué ne se permettrait jamais ça.

>droite
Un visiteur de musée éduqué ne se permettrait jamais ça.

>gauche
Un visiteur de musée éduqué ne se permettrait jamais ça.

* * *

>o
L'inventaire du mémorable
Dans cette première salle, sont regroupés dans trois grandes armoires des objets « merveilleux » comme un mémento mori en forme de crâne, une horloge de table côtoyant des stalactites ou encore un ouvrage (fermé) de C. Plinii 18. En dehors des vitrines, quatre moulages de bustes antiques côtoient des animaux naturalisés. La curiosité du visiteur poursuit sa découverte dans le trompe-l"œil Scarabattolo de Domenico Remps.

>ouest
L'inventaire du mémorable
Dans cette première salle, sont regroupés dans trois grandes armoires des objets « merveilleux » comme un mémento mori en forme de crâne, une horloge de table côtoyant des stalactites ou encore un ouvrage (fermé) de C. Plinii 18. En dehors des vitrines, quatre moulages de bustes antiques côtoient des animaux naturalisés. La curiosité du visiteur poursuit sa découverte dans le trompe-l"œil Scarabattolo de Domenico Remps.

>est
Préambule
Une pièce vide, un mur blanc seulement avec un titre et un code-barre.

Dans cette salle on trouve : yourself, titre and code-barre

* * *

>g
You can't go that way.

>gauche
L'inventaire du mémorable
Dans cette première salle, sont regroupés dans trois grandes armoires des objets « merveilleux » comme un mémento mori en forme de crâne, une horloge de table côtoyant des stalactites ou encore un ouvrage (fermé) de C. Plinii 18. En dehors des vitrines, quatre moulages de bustes antiques côtoient des animaux naturalisés. La curiosité du visiteur poursuit sa découverte dans le trompe-l"œil Scarabattolo de Domenico Remps.

* * *

>o
L'inventaire du mémorable
Dans cette première salle, sont regroupés dans trois grandes armoires des objets « merveilleux » comme un mémento mori en forme de crâne, une horloge de table côtoyant des stalactites ou encore un ouvrage (fermé) de C. Plinii 18. En dehors des vitrines, quatre moulages de bustes antiques côtoient des animaux naturalisés. La curiosité du visiteur poursuit sa découverte dans le trompe-l"œil Scarabattolo de Domenico Remps.

>est
Préambule
Une pièce vide, des murs blancs, le Musée d'art Contemporain de Bordeaux en 1991. 
 À l'ouest se trouve l'Inventaire du mémorable.

>x murs
Tous les murs sont blancs immaculés, celui d'en face annonce le titre et présente un curieux code-barre, celui de droite un tableau signalétique .

>x code barre
Le code-barres est celui de l'exposition, il représente le produit fourni par l'agence ready-made appartiennent à tout le monde ®.

>x titre
Le texte en police Helvetica lit "Feux pâles Exposition réalisée avec le concours de l'agence les ready-made appartiennent à tout le monde" Un code-barre de grande dimension se trouve juste en dessous.

>x tableau
Sur le mur dans le couloir de droite, le sommaire de l'exposition est donné au visiteur, les chapitres sont numérotés. Pour ce cartel de l'exposition, l'artiste utilise un tableau de signalétique rarement employé en institution muséale, il rappelle des codes bureaucratiques de « l'agence ». Le nom des salles/chapitres est rappelé avec le même type de tableau/cartel à l'entrée de chaque grande partie du projet: chapitres 1 et 2 ; chapitres 3 à 6 ; chapitres 7 à 11.

>x pancarte
Sur le mur dans le couloir de droite, le sommaire de l'exposition est donné au visiteur, les chapitres sont numérotés. Pour ce cartel de l'exposition, l'artiste utilise un tableau de signalétique rarement employé en institution muséale, il rappelle des codes bureaucratiques de « l'agence ». Le nom des salles/chapitres est rappelé avec le même type de tableau/cartel à l'entrée de chaque grande partie du projet: chapitres 1 et 2 ; chapitres 3 à 6 ; chapitres 7 à 11.

>x entrée
Vous ne voyez rien de tel, à moins que cela ne soit sans grande importance.

>scanner code barre
Pas de smartphone en 1991

>o
L'inventaire du mémorable
Dans cette première salle, sont regroupés dans trois grandes armoires des objets « merveilleux » comme un mémento mori en forme de crâne, une horloge de table côtoyant des stalactites ou encore un ouvrage (fermé) de C. Plinii 18. En dehors des vitrines, quatre moulages de bustes antiques côtoient des animaux naturalisés. La curiosité du visiteur poursuit sa découverte dans le trompe-l"œil Scarabattolo de Domenico Remps.

>x murs
Vous ne voyez rien de tel, à moins que cela ne soit sans grande importance.

>x moi
Votre nom est Jedermann N.A.

>i
Vous avez :
  un portefeuille (fermé)

>x portefeuille
Un portefeuille tout ce qu'il y a de plus classique.

>ouvrir portefeuille
Vous ouvrez le portefeuille, révélant une carte d'identité, un ticket d'entrée et une CB.

>i
Vous avez :
  un portefeuille (ouvert)
    une carte d'identité
    un ticket d'entrée
    une CB

>prendre cb
Ça fait mieux de rester dans le portefeuille

>lacher portefeuille
Mieux vaut ne pas se séparer de cet objet

>lacher cb
Vous n'avez pas cela.

>donner cb
[Je n'ai pas compris cette phrase.]

* * *

Feux pâles
Une fiction interactive par Alexia Schneider
Release 1 / Serial number 250826 / Inform 7 build 6L38 (I6/v6.33 lib 6/12N) SD

Préambule
L'énigme commence à l'entrée, dans le « préambule » de l'exposition, où est inscrit le titre de l'exposition au-dessus d'un code-barres signé par le capc.  Une pièce vide, des murs blancs, le Musée d'art Contemporain de Bordeaux en 1991. 
 À l'ouest se trouve l'Inventaire du mémorable.

>x me
Tu es Jedermann N.A. En quoi ça consiste exactement ? Allez savoir. Tu tiens un catalogue.

>x g
You see nothing unexpected in that direction.

>g
You see nothing unexpected in that direction.

>gauche
L'inventaire du mémorable
Dans cette première salle, sont regroupés dans trois grandes armoires des objets « merveilleux » comme un mémento mori en forme de crâne, une horloge de table côtoyant des stalactites ou encore un ouvrage (fermé) de C. Plinii 18. En dehors des vitrines, quatre moulages de bustes antiques côtoient des animaux naturalisés. La curiosité du visiteur poursuit sa découverte dans le trompe-l"œil Scarabattolo de Domenico Remps.

* * *

>x me
Tu es Jedermann N.A. En quoi ça consiste exactement ? Allez savoir. Tu tiens un catalogue.

>x moi
Tu es Jedermann N.A. En quoi ça consiste exactement ? Allez savoir. Tu tiens un catalogue.

>x mur
You can't see any such thing.

>test me
(Testing.)

>[1] x me
Tu es Jedermann N.A. En quoi ça consiste exactement ? Allez savoir. Tu tiens un catalogue.

>[2] x titre
Sur le mur blanc, "Feux pâles" en grande lettre noires sans sérif. Un code-barre de grande dimension se trouve juste en dessous.

>[3] g
Sur le mur blanc, "Feux pâles" en grande lettre noires sans sérif. Un code-barre de grande dimension se trouve juste en dessous.

>[4] d
Which do you mean, the est or en bas?

>[5] contemple titre
Sur le mur blanc, "Feux pâles" en grande lettre noires sans sérif. Un code-barre de grande dimension se trouve juste en dessous.

>[6] o
Sorry, that can't be corrected.

>[7] frappe le mur
I didn't understand that sentence.

* * *

Feux pâles
Une fiction interactive par Alexia Schneider
Release 1 / Serial number 250826 / Inform 7 build 6L38 (I6/v6.33 lib 6/12N) SD

Préambule
L'énigme commence à l'entrée, dans le « préambule » de l'exposition, où est inscrit le titre de l'exposition au-dessus d'un code-barres signé par le capc.  Une pièce vide, des murs blancs, le Musée d'art Contemporain de Bordeaux en 1991. 
 À l'ouest se trouve l'Inventaire du mémorable.

>g
I didn't understand that sentence.

>gauche
L'inventaire du mémorable
Dans cette première salle, sont regroupés dans trois grandes armoires des objets « merveilleux » comme un mémento mori en forme de crâne, une horloge de table côtoyant des stalactites ou encore un ouvrage (fermé) de C. Plinii 18. En dehors des vitrines, quatre moulages de bustes antiques côtoient des animaux naturalisés. La curiosité du visiteur poursuit sa découverte dans le trompe-l"œil Scarabattolo de Domenico Remps.

>d
You can't go that way.

>droite
Préambule
Une pièce vide, un mur blanc seulement avec un titre et un code-barre.

Dans cette salle on trouve : yourself, titre and code-barre

* * *

Feux pâles
Une fiction interactive par Alexia Schneider
Release 1 / Serial number 250826 / Inform 7 build 6L38 (I6/v6.33 lib 6/12N) SD

Préambule
L'énigme commence à l'entrée, dans le « préambule » de l'exposition, où est inscrit le titre de l'exposition au-dessus d'un code-barres signé par le capc.  Une pièce vide, des murs blancs, le Musée d'art Contemporain de Bordeaux en 1991. 
 À l'ouest se trouve l'Inventaire du mémorable.

>look
Préambule
Une pièce vide, un mur blanc seulement avec un titre et un code-barre.

Dans cette salle on trouve : yourself, titre and code-barre

>comment on mange des poulpes ?
Feux pâles ne fonctionne qu'avec des instruction comme ">examine a titre", mais pas des questions. Pour plus d'aide, essaie HELP.

* * *

Feux pâles
Une fiction interactive par Alexia Schneider
Release 1 / Serial number 250826 / Inform 7 build 6L38 (I6/v6.33 lib 6/12N) SD

Préambule
L'énigme commence à l'entrée, dans le « préambule » de l'exposition, où est inscrit le titre de l'exposition au-dessus d'un code-barres signé par le capc.  Une pièce vide, des murs blancs, le Musée d'art Contemporain de Bordeaux en 1991. 
 À l'ouest se trouve l'Inventaire du mémorable.

>x moi
Votre nom est Jedermann N.A.

>dal;ksjf
[Je n'ai pas compris cette phrase.]

* * *

>i
Vous avez :
  un portefeuille (fermé)

>ouvrir portefeuille
Vous ouvrez le portefeuille, révélant une carte d'identité, un ticket d'entrée et une CB.

* * *

>i
Vous avez :
  un portefeuille (ouvert)
    une carte d'identité
    un ticket d'entrée
    une CB

>x cb
Un morceau de plastique bien commun pour un compte en banque bien rempli.

>prendre cb
Voilà qui est fait.

>take cb
Vous l'avez déjà.

>i
Vous avez :
  une CB
  un portefeuille (ouvert)
    une carte d'identité
    un ticket d'entrée

* * *

>ouvrir portefeuille
Vous ouvrez le portefeuille, révélant une carte d'identité, un ticket d'entrée et une CB.

>x cb
Un morceau de plastique bien commun pour un compte en banque bien rempli.

>prendre cb
Ca fait mieux de rester dans le portefeuille

>lacher portefeuille
non

>i
Vous avez :
  un portefeuille (ouvert)
    une carte d'identité
    un ticket d'entrée
    une CB

* * *

>x moi
Votre nom est Jedermann N.A.

>w
L'inventaire du mémorable
Dans cette première salle, sont regroupés dans trois grandes armoires des objets « merveilleux » comme un mémento mori en forme de crâne, une horloge de table côtoyant des stalactites ou encore un ouvrage (fermé) de C. Plinii 18. En dehors des vitrines, quatre moulages de bustes antiques côtoient des animaux naturalisés. La curiosité du visiteur poursuit sa découverte dans le trompe-l"œil Scarabattolo de Domenico Remps.

* * *

Feux pâles
Une fiction interactive par Alexia Schneider
Release 1 / Serial number 250826 / Inform 7 build 6L38 (I6/v6.33 lib 6/12N) SD

Préambule
L'énigme commence à l'entrée, dans le « préambule » de l'exposition, où est inscrit le titre de l'exposition au-dessus d'un code-barres signé par le capc.  Une pièce vide, des murs blancs, le Musée d'art Contemporain de Bordeaux en 1991. 
 À l'ouest se trouve l'Inventaire du mémorable.

>lkj;kj
[Je n'ai pas compris cette phrase.]

>mange
[Je n'ai pas compris cette phrase.]

>mange titre
[Je n'ai pas compris cette phrase.]

>le frapper
[Je ne suis pas sûr de ce à quoi « -le » se réfère.]

>frapper titre
Un visiteur de musée éduqué ne se permettrait jamais ça.

>embrasser titre
Vous ne pouvez agir ainsi qu'avec une chose douée de conscience.